TD CR SS SS SS SS
SS SS SS TD SS SS
SS PC SS SS SS SS
CU SS SS SS SS TU
SS CR SS SS SS SS
SS SS TR SS SS SS