SS SS CD SS CU SS
SS SS SS CU SS CU
PC SS TU SS TD SS
SS SS SS TD SS TD
SS SS SS SS SS SS
SS SS SS SS SS SS