CD TR SS SS SS SS
SS TL SS SS TU SS
SS TD PC SS SS SS
SS SS CL SS SS SS
SS SS SS CU CL SS
TR SS SS SS SS SS