SS SS SS SS SS SS
CD SS SS CU TD CD
SS PC SS SS SS SS
CR SS CR SS SS SS
SS CU CD TL SS SS
SS SS SS CL SS SS