CD SS CR SS SS SS
SS TL SS SS CD CU
PC SS SS TD SS SS
CL SS SS SS CD CU
SS CU SS SS SS SS
SS SS TR SS SS SS